"filename", "language", "Python", "Database", "SQLite", "comment", "blank", "total"
"/home/lars/Projects/music-downloader/src/__init__.py", "Python", 0, 0, 0, 0, 1, 1
"/home/lars/Projects/music-downloader/src/create_custom_objects.py", "Python", 80, 0, 0, 3, 18, 101
"/home/lars/Projects/music-downloader/src/metal_archives.py", "Python", 48, 0, 0, 4, 15, 67
"/home/lars/Projects/music-downloader/src/music_kraken/__init__.py", "Python", 57, 0, 0, 8, 25, 90
"/home/lars/Projects/music-downloader/src/music_kraken/__main__.py", "Python", 3, 0, 0, 2, 3, 8
"/home/lars/Projects/music-downloader/src/music_kraken/database/__init__.py", "Python", 18, 0, 0, 0, 5, 23
"/home/lars/Projects/music-downloader/src/music_kraken/database/data_models.py", "Python", 123, 0, 0, 23, 52, 198
"/home/lars/Projects/music-downloader/src/music_kraken/database/database.py", "Python", 84, 0, 0, 48, 26, 158
"/home/lars/Projects/music-downloader/src/music_kraken/database/object_cache.py", "Python", 35, 0, 0, 56, 16, 107
"/home/lars/Projects/music-downloader/src/music_kraken/database/old_database.py", "Python", 432, 0, 0, 154, 115, 701
"/home/lars/Projects/music-downloader/src/music_kraken/database/read.py", "Python", 0, 0, 0, 0, 1, 1
"/home/lars/Projects/music-downloader/src/music_kraken/database/temp_database.py", "Python", 12, 0, 0, 0, 8, 20
"/home/lars/Projects/music-downloader/src/music_kraken/database/write.py", "Python", 210, 0, 0, 62, 63, 335
"/home/lars/Projects/music-downloader/src/music_kraken/not_used_anymore/__init__.py", "Python", 0, 0, 0, 0, 3, 3
"/home/lars/Projects/music-downloader/src/music_kraken/not_used_anymore/fetch_audio.py", "Python", 75, 0, 0, 12, 20, 107
"/home/lars/Projects/music-downloader/src/music_kraken/not_used_anymore/fetch_source.py", "Python", 54, 0, 0, 1, 16, 71
"/home/lars/Projects/music-downloader/src/music_kraken/not_used_anymore/metadata/__init__.py", "Python", 6, 0, 0, 0, 2, 8
"/home/lars/Projects/music-downloader/src/music_kraken/not_used_anymore/metadata/metadata_fetch.py", "Python", 257, 0, 0, 24, 65, 346
"/home/lars/Projects/music-downloader/src/music_kraken/not_used_anymore/metadata/metadata_search.py", "Python", 253, 0, 0, 40, 72, 365
"/home/lars/Projects/music-downloader/src/music_kraken/not_used_anymore/metadata/sources/__init__.py", "Python", 3, 0, 0, 0, 2, 5
"/home/lars/Projects/music-downloader/src/music_kraken/not_used_anymore/metadata/sources/musicbrainz.py", "Python", 42, 0, 0, 6, 12, 60
"/home/lars/Projects/music-downloader/src/music_kraken/not_used_anymore/sources/__init__.py", "Python", 0, 0, 0, 0, 1, 1
"/home/lars/Projects/music-downloader/src/music_kraken/not_used_anymore/sources/genius.py", "Python", 115, 0, 0, 16, 42, 173
"/home/lars/Projects/music-downloader/src/music_kraken/not_used_anymore/sources/local_files.py", "Python", 40, 0, 0, 0, 18, 58
"/home/lars/Projects/music-downloader/src/music_kraken/not_used_anymore/sources/musify.py", "Python", 136, 0, 0, 9, 37, 182
"/home/lars/Projects/music-downloader/src/music_kraken/not_used_anymore/sources/source.py", "Python", 11, 0, 0, 5, 8, 24
"/home/lars/Projects/music-downloader/src/music_kraken/not_used_anymore/sources/youtube.py", "Python", 71, 0, 0, 4, 24, 99
"/home/lars/Projects/music-downloader/src/music_kraken/objects/__init__.py", "Python", 24, 0, 0, 0, 7, 31
"/home/lars/Projects/music-downloader/src/music_kraken/objects/album.py", "Python", 15, 0, 0, 6, 5, 26
"/home/lars/Projects/music-downloader/src/music_kraken/objects/artist.py", "Python", 18, 0, 0, 0, 5, 23
"/home/lars/Projects/music-downloader/src/music_kraken/objects/collection.py", "Python", 52, 0, 0, 15, 24, 91
"/home/lars/Projects/music-downloader/src/music_kraken/objects/formatted_text.py", "Python", 53, 0, 0, 57, 20, 130
"/home/lars/Projects/music-downloader/src/music_kraken/objects/lyrics.py", "Python", 21, 0, 0, 0, 7, 28
"/home/lars/Projects/music-downloader/src/music_kraken/objects/metadata.py", "Python", 262, 0, 0, 68, 63, 393
"/home/lars/Projects/music-downloader/src/music_kraken/objects/parents.py", "Python", 22, 0, 0, 15, 12, 49
"/home/lars/Projects/music-downloader/src/music_kraken/objects/song.py", "Python", 337, 0, 0, 81, 90, 508
"/home/lars/Projects/music-downloader/src/music_kraken/objects/source.py", "Python", 116, 0, 0, 38, 41, 195
"/home/lars/Projects/music-downloader/src/music_kraken/objects/target.py", "Python", 22, 0, 0, 7, 7, 36
"/home/lars/Projects/music-downloader/src/music_kraken/pages/__init__.py", "Python", 7, 0, 0, 0, 5, 12
"/home/lars/Projects/music-downloader/src/music_kraken/pages/abstract.py", "Python", 73, 0, 0, 68, 27, 168
"/home/lars/Projects/music-downloader/src/music_kraken/pages/encyclopaedia_metallum.py", "Python", 341, 0, 0, 66, 91, 498
"/home/lars/Projects/music-downloader/src/music_kraken/pages/youtube.py", "Python", 25, 0, 0, 16, 6, 47
"/home/lars/Projects/music-downloader/src/music_kraken/static_files/new_db.sql", "SQLite", 0, 0, 72, 0, 10, 82
"/home/lars/Projects/music-downloader/src/music_kraken/static_files/temp_database_structure.sql", "SQLite", 0, 0, 135, 0, 10, 145
"/home/lars/Projects/music-downloader/src/music_kraken/tagging/__init__.py", "Python", 8, 0, 0, 0, 2, 10
"/home/lars/Projects/music-downloader/src/music_kraken/tagging/id3.py", "Python", 51, 0, 0, 4, 20, 75
"/home/lars/Projects/music-downloader/src/music_kraken/target/__init__.py", "Python", 4, 0, 0, 0, 2, 6
"/home/lars/Projects/music-downloader/src/music_kraken/target/set_target.py", "Python", 37, 0, 0, 7, 18, 62
"/home/lars/Projects/music-downloader/src/music_kraken/utils/__init__.py", "Python", 1, 0, 0, 1, 1, 3
"/home/lars/Projects/music-downloader/src/music_kraken/utils/functions.py", "Python", 3, 0, 0, 0, 1, 4
"/home/lars/Projects/music-downloader/src/music_kraken/utils/object_handeling.py", "Python", 19, 0, 0, 0, 6, 25
"/home/lars/Projects/music-downloader/src/music_kraken/utils/phonetic_compares.py", "Python", 39, 0, 0, 2, 17, 58
"/home/lars/Projects/music-downloader/src/music_kraken/utils/shared.py", "Python", 62, 0, 0, 3, 10, 75
"/home/lars/Projects/music-downloader/src/music_kraken/utils/string_processing.py", "Python", 2, 0, 0, 5, 2, 9
"/home/lars/Projects/music-downloader/src/music_kraken_cli.py", "Python", 3, 0, 0, 0, 3, 6
"/home/lars/Projects/music-downloader/src/music_kraken_gtk.py", "Python", 3, 0, 0, 0, 2, 5
"/home/lars/Projects/music-downloader/src/test.db", "Database", 0, 91, 0, 0, 1, 92
"/home/lars/Projects/music-downloader/src/tests/__init__.py", "Python", 0, 0, 0, 0, 1, 1
"/home/lars/Projects/music-downloader/src/tests/conftest.py", "Python", 3, 0, 0, 1, 2, 6
"/home/lars/Projects/music-downloader/src/tests/example_data_objects.py", "Python", 36, 0, 0, 5, 6, 47
"/home/lars/Projects/music-downloader/src/try-programming-interface.py", "Python", 14, 0, 0, 98, 22, 134
"/home/lars/Projects/music-downloader/src/try.py", "Python", 1, 0, 0, 0, 3, 4
"/home/lars/Projects/music-downloader/src/try_python.py", "Python", 13, 0, 0, 20, 9, 42
"Total", "-", 3852, 91, 207, 1060, 1228, 6438