"filename", "language", "Python", "SQLite", "comment", "blank", "total"
"/home/lars/Projects/music-downloader/src/__init__.py", "Python", 0, 0, 0, 1, 1
"/home/lars/Projects/music-downloader/src/actual_donwload.py", "Python", 16, 0, 0, 6, 22
"/home/lars/Projects/music-downloader/src/create_custom_objects.py", "Python", 58, 0, 0, 6, 64
"/home/lars/Projects/music-downloader/src/metal_archives.py", "Python", 30, 0, 0, 12, 42
"/home/lars/Projects/music-downloader/src/music_kraken/__init__.py", "Python", 112, 0, 6, 33, 151
"/home/lars/Projects/music-downloader/src/music_kraken/__main__.py", "Python", 98, 0, 3, 23, 124
"/home/lars/Projects/music-downloader/src/music_kraken/audio/__init__.py", "Python", 7, 0, 0, 3, 10
"/home/lars/Projects/music-downloader/src/music_kraken/audio/codec.py", "Python", 25, 0, 0, 8, 33
"/home/lars/Projects/music-downloader/src/music_kraken/audio/metadata.py", "Python", 60, 0, 4, 24, 88
"/home/lars/Projects/music-downloader/src/music_kraken/cli/__init__.py", "Python", 2, 0, 0, 0, 2
"/home/lars/Projects/music-downloader/src/music_kraken/cli/download/__init__.py", "Python", 0, 0, 0, 1, 1
"/home/lars/Projects/music-downloader/src/music_kraken/cli/download/shell.py", "Python", 199, 0, 86, 78, 363
"/home/lars/Projects/music-downloader/src/music_kraken/cli/options/__init__.py", "Python", 3, 0, 0, 1, 4
"/home/lars/Projects/music-downloader/src/music_kraken/cli/options/invidious/__init__.py", "Python", 0, 0, 0, 1, 1
"/home/lars/Projects/music-downloader/src/music_kraken/cli/options/invidious/shell.py", "Python", 66, 0, 7, 28, 101
"/home/lars/Projects/music-downloader/src/music_kraken/connection/__init__.py", "Python", 1, 0, 0, 1, 2
"/home/lars/Projects/music-downloader/src/music_kraken/connection/connection.py", "Python", 168, 0, 1, 30, 199
"/home/lars/Projects/music-downloader/src/music_kraken/connection/rotating.py", "Python", 27, 0, 3, 14, 44
"/home/lars/Projects/music-downloader/src/music_kraken/database/__init__.py", "Python", 0, 0, 0, 1, 1
"/home/lars/Projects/music-downloader/src/music_kraken/database/data_models.py", "Python", 122, 0, 24, 52, 198
"/home/lars/Projects/music-downloader/src/music_kraken/database/database.py", "Python", 104, 0, 47, 38, 189
"/home/lars/Projects/music-downloader/src/music_kraken/download/__init__.py", "Python", 1, 0, 0, 1, 2
"/home/lars/Projects/music-downloader/src/music_kraken/download/multiple_options.py", "Python", 69, 0, 0, 31, 100
"/home/lars/Projects/music-downloader/src/music_kraken/download/page_attributes.py", "Python", 67, 0, 1, 29, 97
"/home/lars/Projects/music-downloader/src/music_kraken/download/results.py", "Python", 62, 0, 7, 26, 95
"/home/lars/Projects/music-downloader/src/music_kraken/download/search.py", "Python", 124, 0, 24, 56, 204
"/home/lars/Projects/music-downloader/src/music_kraken/objects/__init__.py", "Python", 14, 0, 0, 5, 19
"/home/lars/Projects/music-downloader/src/music_kraken/objects/cache.py", "Python", 37, 0, 56, 18, 111
"/home/lars/Projects/music-downloader/src/music_kraken/objects/collection.py", "Python", 91, 0, 31, 39, 161
"/home/lars/Projects/music-downloader/src/music_kraken/objects/formatted_text.py", "Python", 50, 0, 10, 19, 79
"/home/lars/Projects/music-downloader/src/music_kraken/objects/lyrics.py", "Python", 25, 0, 0, 7, 32
"/home/lars/Projects/music-downloader/src/music_kraken/objects/metadata.py", "Python", 272, 0, 62, 63, 397
"/home/lars/Projects/music-downloader/src/music_kraken/objects/option.py", "Python", 28, 0, 0, 13, 41
"/home/lars/Projects/music-downloader/src/music_kraken/objects/parents.py", "Python", 71, 0, 35, 35, 141
"/home/lars/Projects/music-downloader/src/music_kraken/objects/song.py", "Python", 480, 0, 113, 120, 713
"/home/lars/Projects/music-downloader/src/music_kraken/objects/source.py", "Python", 93, 0, 16, 33, 142
"/home/lars/Projects/music-downloader/src/music_kraken/objects/target.py", "Python", 65, 0, 15, 24, 104
"/home/lars/Projects/music-downloader/src/music_kraken/pages/__init__.py", "Python", 4, 0, 0, 2, 6
"/home/lars/Projects/music-downloader/src/music_kraken/pages/abstract.py", "Python", 234, 0, 46, 93, 373
"/home/lars/Projects/music-downloader/src/music_kraken/pages/encyclopaedia_metallum.py", "Python", 432, 0, 90, 127, 649
"/home/lars/Projects/music-downloader/src/music_kraken/pages/musify.py", "Python", 576, 0, 275, 166, 1017
"/home/lars/Projects/music-downloader/src/music_kraken/pages/preset.py", "Python", 47, 0, 1, 17, 65
"/home/lars/Projects/music-downloader/src/music_kraken/pages/youtube.py", "Python", 254, 0, 45, 79, 378
"/home/lars/Projects/music-downloader/src/music_kraken/static_files/new_db.sql", "SQLite", 0, 72, 0, 10, 82
"/home/lars/Projects/music-downloader/src/music_kraken/static_files/temp_database_structure.sql", "SQLite", 0, 135, 0, 10, 145
"/home/lars/Projects/music-downloader/src/music_kraken/utils/__init__.py", "Python", 2, 0, 1, 2, 5
"/home/lars/Projects/music-downloader/src/music_kraken/utils/config/__init__.py", "Python", 7, 0, 0, 4, 11
"/home/lars/Projects/music-downloader/src/music_kraken/utils/config/audio.py", "Python", 152, 0, 15, 28, 195
"/home/lars/Projects/music-downloader/src/music_kraken/utils/config/base_classes.py", "Python", 136, 0, 35, 61, 232
"/home/lars/Projects/music-downloader/src/music_kraken/utils/config/config.py", "Python", 92, 0, 16, 30, 138
"/home/lars/Projects/music-downloader/src/music_kraken/utils/config/connection.py", "Python", 80, 0, 2, 15, 97
"/home/lars/Projects/music-downloader/src/music_kraken/utils/config/logging.py", "Python", 104, 0, 4, 17, 125
"/home/lars/Projects/music-downloader/src/music_kraken/utils/config/misc.py", "Python", 40, 0, 0, 9, 49
"/home/lars/Projects/music-downloader/src/music_kraken/utils/config/paths.py", "Python", 40, 0, 0, 13, 53
"/home/lars/Projects/music-downloader/src/music_kraken/utils/enums/__init__.py", "Python", 0, 0, 0, 1, 1
"/home/lars/Projects/music-downloader/src/music_kraken/utils/enums/album.py", "Python", 16, 0, 6, 5, 27
"/home/lars/Projects/music-downloader/src/music_kraken/utils/enums/source.py", "Python", 40, 0, 1, 8, 49
"/home/lars/Projects/music-downloader/src/music_kraken/utils/exception/__init__.py", "Python", 1, 0, 0, 1, 2
"/home/lars/Projects/music-downloader/src/music_kraken/utils/exception/config.py", "Python", 14, 0, 8, 7, 29
"/home/lars/Projects/music-downloader/src/music_kraken/utils/exception/download.py", "Python", 8, 0, 0, 4, 12
"/home/lars/Projects/music-downloader/src/music_kraken/utils/functions.py", "Python", 3, 0, 0, 1, 4
"/home/lars/Projects/music-downloader/src/music_kraken/utils/object_handeling.py", "Python", 19, 0, 0, 6, 25
"/home/lars/Projects/music-downloader/src/music_kraken/utils/path_manager/__init__.py", "Python", 2, 0, 0, 2, 4
"/home/lars/Projects/music-downloader/src/music_kraken/utils/path_manager/config_directory.py", "Python", 4, 0, 0, 4, 8
"/home/lars/Projects/music-downloader/src/music_kraken/utils/path_manager/locations.py", "Python", 16, 0, 0, 9, 25
"/home/lars/Projects/music-downloader/src/music_kraken/utils/path_manager/music_directory.py", "Python", 36, 0, 9, 14, 59
"/home/lars/Projects/music-downloader/src/music_kraken/utils/phonetic_compares.py", "Python", 39, 0, 2, 17, 58
"/home/lars/Projects/music-downloader/src/music_kraken/utils/regex.py", "Python", 1, 0, 0, 2, 3
"/home/lars/Projects/music-downloader/src/music_kraken/utils/shared.py", "Python", 66, 0, 22, 22, 110
"/home/lars/Projects/music-downloader/src/music_kraken/utils/string_processing.py", "Python", 16, 0, 5, 11, 32
"/home/lars/Projects/music-downloader/src/music_kraken/utils/support_classes/__init__.py", "Python", 4, 0, 0, 1, 5
"/home/lars/Projects/music-downloader/src/music_kraken/utils/support_classes/default_target.py", "Python", 56, 0, 0, 15, 71
"/home/lars/Projects/music-downloader/src/music_kraken/utils/support_classes/download_result.py", "Python", 69, 0, 0, 21, 90
"/home/lars/Projects/music-downloader/src/music_kraken/utils/support_classes/query.py", "Python", 24, 0, 0, 9, 33
"/home/lars/Projects/music-downloader/src/music_kraken/utils/support_classes/thread_classes.py", "Python", 8, 0, 0, 4, 12
"/home/lars/Projects/music-downloader/src/music_kraken_cli.py", "Python", 3, 0, 0, 3, 6
"/home/lars/Projects/music-downloader/src/music_kraken_gtk.py", "Python", 3, 0, 0, 2, 5
"/home/lars/Projects/music-downloader/src/musify_search.py", "Python", 38, 0, 0, 14, 52
"/home/lars/Projects/music-downloader/src/tests/__init__.py", "Python", 0, 0, 0, 1, 1
"/home/lars/Projects/music-downloader/src/tests/conftest.py", "Python", 3, 0, 1, 2, 6
"/home/lars/Projects/music-downloader/src/tests/test_building_objects.py", "Python", 81, 0, 1, 13, 95
"/home/lars/Projects/music-downloader/src/tests/test_download.py", "Python", 30, 0, 1, 12, 43
"/home/lars/Projects/music-downloader/src/tests/test_objects.py", "Python", 173, 0, 15, 51, 239
"Total", "-", 5620, 207, 1152, 1825, 8804