"filename", "language", "Python", "Database", "SQLite", "comment", "blank", "total"
"/home/lars/Projects/music-downloader/src/__init__.py", "Python", 0, 0, 0, 0, 1, 1
"/home/lars/Projects/music-downloader/src/create_custom_objects.py", "Python", 80, 0, 0, 3, 18, 101
"/home/lars/Projects/music-downloader/src/metal_archives.py", "Python", 45, 0, 0, 6, 17, 68
"/home/lars/Projects/music-downloader/src/music_kraken/__init__.py", "Python", 63, 0, 0, 26, 33, 122
"/home/lars/Projects/music-downloader/src/music_kraken/__main__.py", "Python", 3, 0, 0, 2, 3, 8
"/home/lars/Projects/music-downloader/src/music_kraken/database/__init__.py", "Python", 18, 0, 0, 0, 5, 23
"/home/lars/Projects/music-downloader/src/music_kraken/database/database.py", "Python", 429, 0, 0, 112, 111, 652
"/home/lars/Projects/music-downloader/src/music_kraken/database/objects/__init__.py", "Python", 20, 0, 0, 0, 7, 27
"/home/lars/Projects/music-downloader/src/music_kraken/database/objects/artist.py", "Python", 18, 0, 0, 0, 5, 23
"/home/lars/Projects/music-downloader/src/music_kraken/database/objects/formatted_text.py", "Python", 48, 0, 0, 57, 16, 121
"/home/lars/Projects/music-downloader/src/music_kraken/database/objects/metadata.py", "Python", 251, 0, 0, 68, 61, 380
"/home/lars/Projects/music-downloader/src/music_kraken/database/objects/parents.py", "Python", 40, 0, 0, 8, 19, 67
"/home/lars/Projects/music-downloader/src/music_kraken/database/objects/song.py", "Python", 323, 0, 0, 64, 85, 472
"/home/lars/Projects/music-downloader/src/music_kraken/database/objects/source.py", "Python", 116, 0, 0, 38, 41, 195
"/home/lars/Projects/music-downloader/src/music_kraken/database/temp_database.py", "Python", 12, 0, 0, 0, 8, 20
"/home/lars/Projects/music-downloader/src/music_kraken/not_used_anymore/__init__.py", "Python", 0, 0, 0, 0, 3, 3
"/home/lars/Projects/music-downloader/src/music_kraken/not_used_anymore/fetch_audio.py", "Python", 75, 0, 0, 12, 20, 107
"/home/lars/Projects/music-downloader/src/music_kraken/not_used_anymore/fetch_source.py", "Python", 54, 0, 0, 1, 16, 71
"/home/lars/Projects/music-downloader/src/music_kraken/not_used_anymore/metadata/__init__.py", "Python", 6, 0, 0, 0, 2, 8
"/home/lars/Projects/music-downloader/src/music_kraken/not_used_anymore/metadata/metadata_fetch.py", "Python", 257, 0, 0, 24, 65, 346
"/home/lars/Projects/music-downloader/src/music_kraken/not_used_anymore/metadata/metadata_search.py", "Python", 253, 0, 0, 40, 72, 365
"/home/lars/Projects/music-downloader/src/music_kraken/not_used_anymore/metadata/sources/__init__.py", "Python", 3, 0, 0, 0, 2, 5
"/home/lars/Projects/music-downloader/src/music_kraken/not_used_anymore/metadata/sources/musicbrainz.py", "Python", 42, 0, 0, 6, 12, 60
"/home/lars/Projects/music-downloader/src/music_kraken/not_used_anymore/sources/__init__.py", "Python", 0, 0, 0, 0, 1, 1
"/home/lars/Projects/music-downloader/src/music_kraken/not_used_anymore/sources/genius.py", "Python", 115, 0, 0, 16, 42, 173
"/home/lars/Projects/music-downloader/src/music_kraken/not_used_anymore/sources/local_files.py", "Python", 40, 0, 0, 0, 18, 58
"/home/lars/Projects/music-downloader/src/music_kraken/not_used_anymore/sources/musify.py", "Python", 136, 0, 0, 9, 37, 182
"/home/lars/Projects/music-downloader/src/music_kraken/not_used_anymore/sources/source.py", "Python", 11, 0, 0, 5, 8, 24
"/home/lars/Projects/music-downloader/src/music_kraken/not_used_anymore/sources/youtube.py", "Python", 71, 0, 0, 4, 24, 99
"/home/lars/Projects/music-downloader/src/music_kraken/pages/__init__.py", "Python", 7, 0, 0, 0, 5, 12
"/home/lars/Projects/music-downloader/src/music_kraken/pages/abstract.py", "Python", 70, 0, 0, 68, 27, 165
"/home/lars/Projects/music-downloader/src/music_kraken/pages/encyclopaedia_metallum.py", "Python", 299, 0, 0, 60, 76, 435
"/home/lars/Projects/music-downloader/src/music_kraken/pages/youtube.py", "Python", 25, 0, 0, 16, 6, 47
"/home/lars/Projects/music-downloader/src/music_kraken/static_files/new_db.sql", "SQLite", 0, 0, 72, 0, 10, 82
"/home/lars/Projects/music-downloader/src/music_kraken/static_files/temp_database_structure.sql", "SQLite", 0, 0, 135, 0, 10, 145
"/home/lars/Projects/music-downloader/src/music_kraken/tagging/__init__.py", "Python", 8, 0, 0, 0, 2, 10
"/home/lars/Projects/music-downloader/src/music_kraken/tagging/id3.py", "Python", 51, 0, 0, 4, 20, 75
"/home/lars/Projects/music-downloader/src/music_kraken/target/__init__.py", "Python", 4, 0, 0, 0, 2, 6
"/home/lars/Projects/music-downloader/src/music_kraken/target/set_target.py", "Python", 37, 0, 0, 7, 18, 62
"/home/lars/Projects/music-downloader/src/music_kraken/utils/__init__.py", "Python", 1, 0, 0, 1, 1, 3
"/home/lars/Projects/music-downloader/src/music_kraken/utils/functions.py", "Python", 3, 0, 0, 0, 1, 4
"/home/lars/Projects/music-downloader/src/music_kraken/utils/object_handeling.py", "Python", 19, 0, 0, 0, 6, 25
"/home/lars/Projects/music-downloader/src/music_kraken/utils/phonetic_compares.py", "Python", 39, 0, 0, 2, 17, 58
"/home/lars/Projects/music-downloader/src/music_kraken/utils/shared.py", "Python", 62, 0, 0, 3, 10, 75
"/home/lars/Projects/music-downloader/src/music_kraken/utils/string_processing.py", "Python", 2, 0, 0, 5, 2, 9
"/home/lars/Projects/music-downloader/src/music_kraken_cli.py", "Python", 91, 0, 0, 9, 32, 132
"/home/lars/Projects/music-downloader/src/music_kraken_gtk.py", "Python", 3, 0, 0, 0, 2, 5
"/home/lars/Projects/music-downloader/src/test.db", "Database", 0, 91, 0, 0, 1, 92
"/home/lars/Projects/music-downloader/src/try-programming-interface.py", "Python", 14, 0, 0, 98, 22, 134
"/home/lars/Projects/music-downloader/src/try_python.py", "Python", 13, 0, 0, 1, 6, 20
"Total", "-", 3277, 91, 207, 775, 1028, 5378